0000011111
0000012251
1111112221
1222212221
1222212221
1222211121
1222222221
1111211111
0000400000