0000400000
0001210000
0001210000
0001210000
0111210000
0122211110
0122222210
0122222224
0111111110
