1111111000
1222221000
1222221000
1222221000
1222111000
1222111110
1222222224
1111111110
0000000000