0000400000
0001210000
0001210000
0001210000
0001210000
0111210000
4222210000
0111210000
0000400000