0000000000
0000111110
0000122210
0111122210
0122222210
0122222210
0122222210
4222222210
0111111110
